##########
#........#
#........#
#........#
#........#
#........#
#........#
#........#
#.......@#
##########