##########
#..#.....#
#..#..#..#
#..#@#...#
#..##....#
#......#.#
#.#.#.#..#
#....#...#
#........#
##########